ài	爱	to love; affection; to be fond of; to like
bā	八	eight; 8
bà ba	爸爸	father (informal); CL:个[ge4] ,位[wei4]
běi jīng	北京	Beijing; capital of People's Republic of China; Peking; PRC government
bēi zi	杯子	cup; glass; CL:个[ge4] ,支[zhi1]
běn	本	origin; source; roots or stems of plants; this; the current; root; foundation; basis; classifier for books, periodicals, files etc; originally
bù	不	not (negative prefix); no
bú kè qi	不客气	you're welcome; it's my pleasure (answer to someone who thanks)
cài	菜	dish (type of food); vegetables; vegetable; cuisine; CL:盘[pan2] ,道[dao4]
chá	茶	tea; tea plant; CL:杯[bei1] ,壶[hu2]
chī	吃	to eat; to have one's meal; to eradicate; to destroy; to absorb; to suffer; to exhaust
chū zū chē	出租车	taxi
dà	大	big; huge; large; major; great; wide; deep; oldest; eldest
dǎ diàn huà	打电话	to make a phone call
de	的	of; structural particle: used before a noun, linking it to preceding possessive or descriptive attributive
diǎn	点	a little; a bit; drop (of liquid); stain; spot; speck; jot; dot stroke (in Chinese characters); decimal point; point; mark (of degree or level); a place (with certain characteristics); iron bell; o’clock; some; (point) unit of measurement for type; to touch on briefly; to make clear; to light; to ignite; to kindle; period of time at night (24 minutes) (old); a drip; to dibble; classifier for small indeterminate quantities
diàn nǎo	电脑	computer; CL:台[tai2]
diàn shì	电视	television; TV; CL:台[tai2] ,个[ge4]
diàn yǐng	电影	movie; film; CL:部[bu4] ,幕[mu4] ,场[chang3]
dōng xi	东西	thing; stuff; person; CL:个[ge4] ,件[jian4]
dōu	都	all, both; entirely (due to) each; even; already
dú	读	to read; to study; reading of word (i.e. pronunciation), similar to 拼音[pin1 yin1]
duì bu qǐ	对不起	I'm sorry; excuse me; pardon me; if you please; sorry? (please repeat); unworthy; to let down;
duō	多	many; much; a lot of; numerous; multi-
duō shǎo	多少	how much; how many
èr	二	two; 2; stupid (Beijing dialect)
ér zi	儿子	son
fàn diàn	饭店	restaurant; hotel; CL:家[jia1],個|个[ge4];
fēi jī	飞机	airplane; CL: 架[jia4]
fēn zhōng	分钟	minute
gāo xìng	高兴	happy; glad; willing (to do sth); in a cheerful mood
gè	个	classifier for people or objects in general; individual; this; that; size
gōng zuò	工作	job; work; construction; task; CL:个[ge4] ,份[fen4] ,项[xiang4]
gǒu	狗	dog; CL:只[zhi1] ,条[tiao2]
hàn yǔ	汉语	Chinese language
hào	号	day of a month; (suffix used after) name of a ship; (ordinal) number
hǎo	好	good; well; proper; good to; easy to; very; so; (suffix indicating completion or readiness)
hé	和	and; together with; with; sum; union; peace; harmony; surname He
hē	喝	to drink; to shout (a command)
hěn	很	very; (adverb of degree); quite; awfully
hòu miàn	后面	rear; back; behind; later; afterwards
huí	回	to go back; to turn around; to answer; to return; to circle; to revolve; Hui ethnic group; time; classifier for acts of a play; section or chapter (of a classic book)
huì	会	can; be possible; be able to; will; be likely to; be sure to; to assemble; to meet; to gather; to see; union; group; association; a moment (Taiwan pr. for this sense is hui3)
jǐ	几	how much; how many; several; a few
jiā	家	home; family; classifier for families or businesses; refers to the philosophical schools of pre-Han China; noun suffix for specialists in some activity such as musician or revolutionary, corresponds to English -ist, -er, -ary or -ian; surname Jia; CL:个[ge4]
jiào	叫	to call; to shout; to order; to ask; to be called; by (indicates agent in the passive mood)
jīn tiān	今天	today; at the present
jiǔ	九	nine; 9
kāi	开	to open; to start; to turn on; to operate (vehicle)
kàn	看	to look at
kàn jiàn	看见	to see; to catch sight of
kuài	块	unit of currency; lump (of earth); chunk; piece; classifier for pieces of cloth, cake, soap etc; colloquial word for yuan (or other unit of currency such as Hong Kong or US dollar etc), usually as 块钱
lái	来	to come; to arrive; to come round; ever since; next
lǎo shī	老师	teacher; CL:个[ge4] ,位[wei4]
le	了	(completed action marker); (modal particle intensifying preceding clause)
lěng	冷	cold
lǐ	里	inside; lining; interior; internal
liù	六	six; 6
ma	吗	(question tag)
mā ma	妈妈	mum; mama; mommy; mother; CL:个[ge4] ,位[wei4]
mǎi	买	to buy; to purchase
māo	猫	cat; CL:只[zhi1]
méi guān xi	没关系	it doesn't matter
méi yǒu	没有	haven't; hasn't; doesn't exist; to not have; to not be;
mǐ fàn	米饭	(cooked) rice
míng tiān	明天	tomorrow
míng zi	名字	name (of a person or thing); CL:个[ge4]
nà	那	that; those; then (in that case); commonly pr. [nei4] before a classifier, esp. in Beijing;
nǎ	哪	which? (interrogative, followed by classifier or numeral-classifier);
nǎ er	哪儿	where?; wherever; anywhere
ne	呢	(question particle for subjects already mentioned)
néng	能	to be able to; to be capable of; ability; capability; able; capable; can possibly; (usually used in the negative) to have the possibility of
nǐ	你	you (informal)
nián	年	year; CL:个[ge4]
nǚ ér	女儿	daughter
péng you	朋友	friend; CL:个[ge4] ,位[wei4]
piào liang	漂亮	pretty; beautiful
píng guǒ	苹果	apple; CL:个[ge4] ,颗[ke1]
qī	七	seven; 7
qián	钱	coin; money; CL:笔[bi3]
qián miàn	前面	ahead; in front; preceding; above
qǐng	请	to ask; to invite; please (do sth); to treat (to a meal etc); to request
qù	去	to go; to go to (a place); to cause to go or send (sb); to remove; to get rid of; (when used either before or after a verb) to go in order to do sth; to be apart from in space or time; (after a verb of motion indicates movement away from the speaker); (used after certain verbs to indicate detachment or separation); (of a time or an event etc) just passed or elapsed
rè	热	heat; to heat up; fervent; hot (of weather); warm up
rén	人	man; person; people; CL:个[ge4] ,位[wei4]
rèn shi	认识	to know; to recognize; to be familiar with; acquainted with sth; knowledge; understanding; awareness; cognition
sān	三	three; 3
shàng	上	on
shāng diàn	商店	store; shop; CL:家[jia1] ,个[ge4]
shàng wǔ	上午	morning; CL:个[ge4]
shǎo	少	few; little; lack
shéi	谁	who; also pronounced shui2
shén me	什么	what?; who?; something; anything
shí	十	ten; 10
shì	是	to be; yes
shí hou	时候	time; length of time; moment; period
shū	书	book; letter; CL:本[ben3] ,册[ce4] ,部[bu4]; see also Book of History
shuǐ	水	water; river; liquid; beverage
shuì jiào	睡觉	to go to bed; to go to sleep
shuǐguǒ	水果	fruit
shuō	说	to speak; to say; to explain; to scold; to tell off; a theory (usually in compounds such as 日心说 heliocentric theory);
sì	四	four; 4
suì	岁	classifier for years (of age); year; year (of crop harvests)
tā	她	she
tā	他	he or him; (used for either sex when the sex is unknown or unimportant); (used before sb's name for emphasis); (used as a meaningless mock object); other; another
tài	太	too (much); very; extremely; highest; greatest
tiān qì	天气	weather
tīng	听	to listen; to hear; to obey; a can (loanword from English 'tin'); classifier for canned beverages
tóng xué	同学	(fellow) classmate; CL:位[wei4] ,个[ge4]
wèi	喂	hello (interj., esp. on telephone); hey
wǒ	我	I; me; my
wǒ men	我们	we; us; ourselves; our
wǔ	五	five; 5
xǐ huan	喜欢	to like; to be fond of
xià	下	down; downwards; below; lower; later; next (week etc); second (of two parts); to decline; to go down
xià wǔ	下午	afternoon; p.m.; CL:个[ge4]
xià yǔ	下雨	to rain; rainy
xiān sheng	先生	Mister (Mr.); husband; doctor (topolect); teacher; CL:个[ge4] ,位[wei4]
xiàn zài	现在	now; at present; at the moment; modern; current; nowadays
xiǎng	想	to think; to believe; to suppose; to wish; to want; to miss
xiǎo	小	small; tiny; young
xiǎo jie	小姐	young lady; Miss; (slang) prostitute; CL:个[ge4] ,位[wei4]
xiě	写	to write
xiē	些	some; few; several; (a measure word)
xiè xie	谢谢	to thank; thanks
xīng qī	星期	week; CL:个[ge4]
xué sheng	学生	student; school child
xué xí	学习	to learn; to study
xué xiào	学校	school; CL:所[suo3]
yī	一	one; 1; single; a (article); as soon as; entire; whole; all; throughout; 'one' radical in Chinese characters (Kangxi radical 1)
yī diǎn er	一点儿	a little (bit)
yī fu	衣服	clothes; CL:件[jian4] ,套[tao4]
yī shēng	医生	doctor; CL:个[ge4] ,位[wei4] ,名[ming2]
yī yuàn	医院	hospital; CL:所[suo3] ,家[jia1] ,座[zuo4]
yǐ zi	椅子	chair; CL:把[ba3] ,套[tao4]
yǒu	有	to have; there is; there are; to exist; to be
yuè	月	month; moon; CL:个[ge4] ,轮[lun2]
zài	在	(located) at; (to be) in; to exist; in the middle of doing sth; (indicating an action in progress)
zài jiàn	再见	goodbye; see you again later
zěn me	怎么	how?; what?; why?
zěn me yàng	怎么样	how are things? how?; how about?; how was it?
zhè	这	this; these; (commonly pr. [zhei4] before a classifier, esp. in Beijing);
zhōng guó	中国	China; Middle Kingdom
zhōng wǔ	中午	noon; midday; CL:个[ge4]
zhù	住	to live; to dwell; to stay; to reside; to stop
zhuō zi	桌子	table; desk; CL:张[zhang1] ,套[tao4]
zì	字	letter; character; word; symbol; CL:个[ge4]
zuò	坐	to sit; to take a seat; to take (a bus, airplane etc); to bear fruit
zuò	做	to do; to make; to produce; to write; to compose; to act as; to engage in; to hold (a party); to be; to become; to function (in some capacity); to serve as; to be used for; to form (a bond or relationship); to pretend; to feign; to act a part; to put on appearance
zuó tiān	昨天	yesterday